22,15,
A  ###################
                     #
#  ####  #############
#  #  #        #     #
#  #  #######  #  #  #
#  #     #        #  #
#######  ####  #  ####
#           #  #     #
####  #  ##########  #
#     #              #
####  #  #######  ####
#     #        #     #
#  ##########  ####  #
#     #        #      
###################  B




